8
EEEEEEEE
EEEEEEEE
WWWWWEEE
WEEEWEEE
WEWEWEEE
WEWEWWWW
WEBEGEEW
WWWWWWWW
