8
EEEEEEEE
EEEEEEEE
EEWWWEEE
EEWEWWWE
EEWGEEWE
EEWWBEWE
EEEWEEWE
EEEWWWWE
