8
EEEEWWWE
EEEEWGWE
EEEEWEWE
WWWWWEWW
WEEEBEEW
WEWEEEBW
WEBPGWGW
WWWWWWWW
