8
EEEEEEEE
EEEEEEEE
EEEEEEEE
EEWWWWWE
EEWEEEWW
EEWWWEEW
EEWGEBEW
EEWWWWWW
