8
EWWWWWEE
EWEBGWWW
EWEWWWPW
EWEEEEEW
EWWWWWWW
EEEEEEEE
EEEEEEEE
EEEEEEEE
