8
EEEEWWWW
EEEEWEPW
EEWWWEWW
EEWEEEWE
EEWEWEWE
EEWEBBWW
EEWWEGGW
EEEWWWWW
