8
EWWWWEEE
EWEEWEEE
EWEBWEEE
EWEEWEEE
EWWEWEEE
EEWPWEEE
EEWGWEEE
EEWWWEEE
