8
EEEEEEEE
EEEEEEEE
EEEEEEEE
WWWWWWEE
WPEEEWEE
WBWWEWEE
WGGBEWEE
WWWWWWEE
