8
EEEEEEEE
EEWWWEEE
EEWGWEEE
WWWEWWEE
WEEEEWEE
WEBBEWEE
WGWEEWEE
WWWWWWEE
