8
EEEWWWWW
EEEWEEPW
EEEWBWEW
EEEWGWEW
EEEWWWBW
EEEEEWGW
EEEEEWWW
EEEEEEEE
