8
EEEEEEEE
EEEWWWWE
EEWWEEWE
EEWEEWWE
EEWEWWWW
EEWEBEGW
EEWWWWWW
EEEEEEEE
