8
WWWWWWWE
WEGEBEWE
WEWEWEWW
WEGBEGEW
WWBWEEEW
EWEPEWWW
EWWWWWEE
EEEEEEEE
