8
EEWWWWWW
EEWPEEGW
EEWEEBEW
EEWEEWWW
EWWEWWEE
WWEEWEEE
WGBEWEEE
WWWWWEEE
