8
WWWWWEEE
WGEEWWWE
WWBEWPWE
EWEEEEWE
EWWWEEWE
EEEWBWWE
EEEWGWEE
EEEWWWEE
