8
EEEEEEEE
EEEEEEEE
WWWWWWWW
WEEEGEEW
WGBBEEEW
WWEWWWWW
EWWWEEEE
EEEEEEEE
