8
WWWWEEEE
WEPWWWWE
WEEBEEWE
WGWEWEWE
WWWEEEWE
EEWWWWWE
EEEEEEEE
EEEEEEEE
