8
EEEEEEEE
EEEEEEEE
EEEWWWWE
EEWWEEWE
WWWEEBWE
WEEEWGWE
WWWWWWWE
EEEEEEEE
