8
EEEEEEEE
EEEWWWWW
EWWWEEEW
EWEEEWGW
EWEWEBEW
EWWWEEBW
EEEWWWGW
EEEEEWWW
