8
EEEWWWWW
EEEWPEEW
EEEWWEBW
EEWWEEGW
EEWEEWWW
EEWBWWEE
EEWGWEEE
EEWWWEEE
