8
EEEEEEEE
EEEEEEEE
EWWWWWEE
EWEEPWEE
EWEWBWWW
EWEEEEGW
EWWWWWWW
EEEEEEEE
