8
EEEEEEEE
EEWWWWEE
EEWEEWEE
EEWEWWWW
EEWEBGGW
EEWWEWBW
EEEWEEEW
EEEWWWWW
