8
EEEEEEEE
EEEEEEEE
EEEEEEEE
EEEEEEEE
WWWWWEEE
WEEEWWWW
WEEBPEGW
WWWWWWWW
