8
EWWWWWEE
WWEEEWEE
WEBWEWEE
WBEPGWEE
WGWWWWEE
WWWEEEEE
EEEEEEEE
EEEEEEEE
