8
EEEEEEEE
EEEEEWWW
EEEWWWBW
EEEWEEEW
EEEWBWEW
EEEWEWGW
EEEWGWWW
EEEWWWEE
