8
WWWEWWWE
WGWEWGWE
WBWEWBWE
WEWWWEWE
WEWEEEWW
WEEEWEPW
WWWWWWWW
EEEEEEEE
