8
WWWWWWWW
WEEEEEGW
WPEBEWWW
WEEWWWEE
WWWWEEEE
EEEEEEEE
EEEEEEEE
EEEEEEEE
