8
EWWWWWEE
EWEEEWWE
EWEWEEWE
EWEWWBWE
EWWWWEWE
EEEWEEWW
EEEWEEGW
EEEWWWWW
