8
EEEEEEEE
EEEEEEEE
EEWWWWEE
EEWEEWEE
EEWEBWEE
EEWEPWWW
EEWEEEGW
EEWWWWWW
