8
EEEEEEEE
EEEWWWEE
WWWWGWEE
WGWWBWWE
WBGEEEWE
WPWWBEWE
WWWWEEWE
EEEWWWWE
