8
EEEEEEEE
EEEEEEEE
EEEEEEEE
EEEEEEEE
WWWWWWWW
WGBGPBEW
WWWWEEEW
EEEWWWWW
