8
EEEEEEEE
WWWWWWEE
WGBEEWWW
WWWWEEGW
EEEWWEEW
EEEEWEBW
EEEEWEEW
EEEEWWWW
