8
WWWWWWWW
WGEEEBEW
WWWWEBPW
EEEWWWGW
EEEEEWWW
EEEEEEEE
EEEEEEEE
EEEEEEEE
