8
EEEEEEEE
EEEEEEEE
EEWWWEEE
EEWGWWWW
EWWBWWGW
EWEEWWBW
EWWEEEEW
EEWWWWWW
