8
EEEEEEEE
EEEEEEEE
EEEEEEEE
EEEEEEEE
WWWWWWWW
WPWWEEEW
WEEEGBEW
WWWWWWWW
