8
WWWWWWWW
WEEEWGEW
WGEWPEWW
WBWEEBEW
WEWEEEWW
WEEEBWWE
WEWGEWEE
WWWWWWEE
