8
EEEEEEEE
EWWWWWWE
EWEEEGWE
EWEWEWWE
EWEEEWEE
EWWWBWEE
EEEWEWEE
EEEWWWEE
