8
EEEWWWWW
EEEWEEGW
EEEWEBWW
EEEWWEWE
EEWWWEWE
WWWEEEWE
WGBEWEWE
WWWWWWWE
