8
EEEEEEEE
WWWWWWEE
WGEEEWEE
WWWEEWEE
EWWBWWEE
EWEEWEEE
EWWWWEEE
EEEEEEEE
