8
EEEWWWWW
EEEWGBEW
EEWWWEEW
EEWEEEGW
EEWEBWWW
EEWWWWEE
EEEEEEEE
EEEEEEEE
