8
EEWWWWEE
EEWEEWWE
EEWBEPWE
WWWEWEWE
WGEBEEWE
WWWGWWWE
EEWWWEEE
EEEEEEEE
