8
EEEEEEEE
EEEWWWWW
EEWWEBGW
EEWEPWWW
WWWEWWEE
WGBEWEEE
WWWWWEEE
EEEEEEEE
