8
WWWWW   
W   W   
W WBW   
W   W   
WWW W   
 W  WW  
 W  GW  
 WWWWW  
