8
EEEEEEEE
EEEEEEEE
EEEEEEEE
EWWWWWWW
EWEBGWEW
EWEWWWEW
EWEEEEEW
EWWWWWWW
