8
WWWWWEEE
WEEEWWEE
WBEEEWEE
WGWEEWEE
WWWEBWWW
EEWEPEGW
EEWWWWWW
EEEEEEEE
