8
EEEEEEEE
EEEWWWEE
EEEWBWEE
EEEWGWWW
EEEWEEEW
EEEWEEBW
EEEWEEGW
EEEWWWWW
