8
WWWEEEEE
WGWWWEEE
WEEEWEEE
WPBEWEEE
WWEEWEEE
EWWWWEEE
EEEEEEEE
EEEEEEEE
