8
EEEWWWWW
EEWWEEEW
EEWPEWEW
EEWWWWEW
EEEEEWEW
EEEEEWBW
EEEEEWGW
EEEEEWWW
