8
WWWWWWEE
WGEEEWWE
WWEEEEWE
EWEBWPWE
EWEEWWWE
EWWWWEEE
EEEEEEEE
EEEEEEEE
