8
EEWWWWWW
EEWGEBEW
WWWWBEEW
WGEEBPWW
WGEEEEWE
WWWWWWWE
EEEEEEEE
EEEEEEEE
