8
EEWWWWWW
EWWEEEEW
EWEPWWBW
EWEWWWGW
EWEEEWWW
WWWWEWEE
WGBEEWEE
WWWWWWEE
