8
EEEEEWWW
EEEEEWPW
EEEEWWEW
EEEWWEEW
EEWWEEWW
WWWEEWWE
WGBEWWEE
WWWWWEEE
