8
WWWWEEEE
WEEWWEEE
WEBEWEEE
WEEPWEEE
WGBWWEEE
WEEWEEEE
WGWWEEEE
WWWEEEEE
