8
EEEWWWEE
EEEWGWEE
EEEWEWEE
EEWWBWEE
WWWEEWWE
WEEEWPWE
WEBEEGWE
WWWWWWWE
