8
EEEEWWWE
EEEEWEWE
EEEEWBWE
EEEEWEWE
EEEWWEWE
EEEWEEWW
EEEWEEGW
EEEWWWWW
