8
WWWWWWW 
W     W 
WBWBWBW 
WGWGWGW 
WWWWWWW 
        
        
        
