8
WWWWWEEE
WGEEWWWE
WWBGEEWE
EWEBEEWE
EWWEEWWE
EEWWPWEE
EEEWWWEE
EEEEEEEE
