8
EEEWWWWW
EEEWEEEW
EEEWEBEW
EEEWEWWW
EEEWGWWE
EEEWEEWE
EEEWWWWE
EEEEEEEE
