8
EEEEEEEE
EEEEEEEE
EEEEEEEE
EEEWWWWE
EEEWEEWE
EWWWBEWE
EWGBGEWE
EWWWWWWE
