8
EEEEWWWE
EEEEWGWE
EEEEWEWE
EEEEWEWW
EEWWWBGW
EEWEBEPW
EEWEEEEW
EEWWWWWW
