8
EEEWWWEE
EEWWGWEE
EEWEEWEE
WWWBBWEE
WGPEEWEE
WWWWWWEE
EEEEEEEE
EEEEEEEE
