8
EEEEEEEE
EEEWWWWW
EEEWGBEW
EEEWWWEW
EEEWWEEW
EEEWPEWW
EEEWEBGW
EEEWWWWW
