8
EEEEEEEE
EEEEEEEE
EEEEEEEE
WWWWWWWW
WEGBEEEW
WWWEEWEW
EEWWEEEW
EEEWWWWW
