8
WWWEEWWW
WGWWWWPW
WEBEWEEW
WEEEEEWW
WWWBWWWE
EEWEWEEE
EEWGWEEE
EEWWWEEE
