8
EEEEWWWW
EEEEWEPW
EEEEWBBW
EEEEWEEW
EEEEWEGW
EEEEWGWW
EEEEWWWE
EEEEEEEE
