8
EEEEEEEE
EEEEEEEE
EEEEEEEE
WWWWWEEE
WEBGWEEE
WEEEWWWW
WWWEEEPW
EEWWWWWW
