8
EEWWWWWW
EEWEEEEW
EEWEWBEW
EEWBEEPW
EEWEWWGW
EEWEWWWW
EEWGWEEE
EEWWWEEE
