8
WWWWWWEE
WWEEWWEE
W2BEWWEE
WWBEWWEE
WWEBEWEE
WGBEEWEE
WGGCGWEE
WWWWWWEE
