8
WWWWWWWE
WGGGEEWE
WEB2BEWW
WWEWWEEW
EWEEBEEW
EWEEWEEW
EWWWWWWW
EEEEEEEE