20
WWWWWWWWWWWWWWWWWWEE
W2BEEEEEEEEEEEEEGWHE
WEEEEEEEEEEEEEEEEWEE
WEBEEEEEEEEEEEEEGWEE
WEEEEEEEEEEEEEEEEWEE
WEBEEEEEEEEEEEEEGWEE
WEEEEEEEEEEEEEEEEWEE
WEBEEEEEEEEEEEEEGWEE
WEEEEEEEEEEEEEEEEWEE
WEBEEEEEEEEEEEEEGWEE
WEEEEEEEEEEEEEEEEWEE
WEBEEEEEEEEEEEEEGWEE
WWWWWWWWWWWWWWWWWWEE
EVEEEEEEEEEEEEEEEEEE
EEEEEEEEEEEEEEEEEEEE
EEEEEEEEEEEEEEEEEEEE
EEEEEEEEEEEEEEEEEEEE
EEEEEEEEEEEEEEEEEEEE
EEEEEEEEEEEEEEEEEEEE
EEEEEEEEEEEEEEEEEEEE