8
EEEEWWWW
EEEWWEEW
EEEWEEBW
EEEWBEGW
EEEWGEWW
EEEWWEEW
EEEEWWWW
EEEEEEEE
