8
WWWWWEEE
WEBGWEEE
WPBWWEEE
WEBGWEEE
WWGWWEEE
EWWWEEEE
EEEEEEEE
EEEEEEEE
