8
EEWWWWWE
EEWEEGWE
WWWBEWWE
WEEEEWEE
WEWWEWEE
WEEPEWEE
WWWWWWEE
EEEEEEEE
