8
EEEEWWWE
EEEEWEWE
EEEEWEWE
EEEEWEWE
EEEEWEWW
EEWWWEEW
EEWGEBEW
EEWWWWWW
