8
EWWWWEEE
EWEEWWEE
WWEBGWEE
WGBEEWEE
WGBEEWEE
WEPWWWEE
WWWWEEEE
EEEEEEEE
