8
WWWEEEEE
WGWWEEEE
WBEWWEEE
WEEEWEEE
WGPEWEEE
WEBWWEEE
WEEWEEEE
WWWWEEEE
