8
WWWWWWWW
WEEEGEGW
WEWBEWWW
WEEBEWEE
WEWEWWEE
WPEEWEEE
WWWWWEEE
EEEEEEEE
