8
EEEWWWWE
EEEWEEWE
EEWWBEWW
EEWEEEGW
EEWEEWWW
EEWWBWEE
EEEWGWEE
EEEWWWEE
