8
EWWWWWWE
EWEEWPWE
EWEEBEWE
EWEGEWWE
EWWWWWEE
EEEEEEEE
EEEEEEEE
EEEEEEEE
