8
WWWWEEEE
WEEWWWWE
WEEEBEWW
WGWWWEPW
WWWEWWWW
EEEEEEEE
EEEEEEEE
EEEEEEEE
