8
EEEWWWEE
EEEWEWEE
EEWWEWWW
EEWGBEEW
EEWWEWEW
EEEWEEEW
EEEWWWWW
EEEEEEEE
