8
EEWWWEEE
EWWPWEEE
EWEEWWWE
EWEWEEWE
EWEEBEWE
EWWWWGWE
EEEEWWWE
EEEEEEEE
