8
EEEEEEEE
EEEEEEEE
EEWWWWWE
EEWEEEWE
EWWEWBWE
EWEEBEWE
EWWGWGWE
EEWWWWWE
