8
EEEEEEEE
EEEEEEEE
EWWWWWEE
EWBEEWWW
EWEWEEEW
EWGWWWBW
EWWWEWGW
EEEEEWWW
