8
EEEEWWWE
EEEEWGWE
EEEEWEWE
EEEEWPWW
EEEEWBEW
EEEEWEEW
EEEEWEEW
EEEEWWWW
