8
EEEEEEEE
EEEEEEEE
EWWWWWWW
EWGEBEGW
EWWEBEWW
EEWEEEWE
EEWWWEWE
EEEEWWWE
