8
EEWWWWWE
EEWGBEWE
EEWWWPWE
EEEWEBWW
EEEWEEGW
EEEWWWWW
EEEEEEEE
EEEEEEEE
