8
WWWWWWWW
WGEEBEEW
WWPWEEEW
EWWWWWWW
EEEEEEEE
EEEEEEEE
EEEEEEEE
EEEEEEEE
