8
EEEEEEEE
EEEEEEEE
EEWWWWWE
EWWEBGWE
EWEEWWWW
WWEWWWPW
WGEEBEEW
WWWWWWWW
