8
EEEEEEEE
EEEEEEEE
EWWWWEEE
WWGPWEEE
WEBWWEEE
WEEWEEEE
WEEWEEEE
WWWWEEEE
