8
EEEWWWEE
EEEWGWEE
EWWWEWEE
EWEEEWWE
EWWWBEWE
EEEWEEWE
EEEWEEWE
EEEWWWWE
