8
WWWWWWEE
WGEEEWEE
WWWEEWWW
EEWEEBEW
EEWEEWWW
EEWWWWEE
EEEEEEEE
EEEEEEEE
