8
EEEWWWEE
EEWWGWEE
EWWEEWEE
EWGBEWEE
EWEEEWWW
EWBWEBEW
EWEEGPEW
EWWWWWWW
