8
EEEEEEEE
EEEWWWEE
EEEWPWWE
EEEWEGWW
EEEWWBEW
EEEEWEEW
EEEEWEEW
EEEEWWWW
