8
WWWWWWWE
WEEEBGWE
WEWEEWWE
WBWWWWEE
WGWEEEEE
WWWEEEEE
EEEEEEEE
EEEEEEEE
