8
EWWWWWEE
EWEBGWWE
EWEEWGWE
EWWEWBWE
EEWEEPWE
EEWWWWWE
EEEEEEEE
EEEEEEEE
