8
EEEEEEEE
WWWWWWEE
WEGEEWEE
WEPBEWEE
WEEWWWEE
WWWWEEEE
EEEEEEEE
EEEEEEEE
