8
EEWWWWWE
EEWGPEWE
EEWEWEWW
EEWBEEEW
EEWEGBEW
EEWWWWWW
EEEEEEEE
EEEEEEEE
