8
EEWWWWWW
EEWGEBEW
EEWWWEEW
WWWWWEWW
WEEEEEWE
WPWWWWWE
WWWEEEEE
EEEEEEEE
