8
EEWWWWWE
EWWEEEWE
WWEBWEWE
WEEBEEWE
WEWEEEWE
WEEGEEWW
WGEEWEPW
WWWWWWWW
