8
WWWWWWWW
WGEPBEGW
WWWEEBEW
EEWWWEEW
EEEEWWWW
EEEEEEEE
EEEEEEEE
EEEEEEEE
