8
EEEEEWWW
EEEEEWGW
WWWWWWBW
WGWWEEEW
WEBEEWWW
WEWEWWWE
WEEEEEWE
WWWWWWWE
