8
EEEEEWWW
EEEEEWGW
EEEEEWBW
EWWWWWEW
EWGBEWPW
EWWWEWEW
EEEWEEEW
EEEWWWWW
