8
EEEEWWWW
EEWWWEEW
EEWEBEEW
EEWWEWGW
EEEWEBGW
EEEWWWWW
EEEEEEEE
EEEEEEEE
