10
WWWWWEEEEE
W2EEWEEEEE
WEBBWEWWWE
WEBEWEWGWE
WWWEWWWGWE
EWWEEEEGWE
EWEEEWEEWE
EWEEEWWWWE
EWWWWWEEEE
EEEEEEEEEE