8
EEEWWWWW
EEEWGEEW
EWWWWEEW
EWEEBEWW
EWEWEEWE
EWPEWWWW
EWWEEBGW
EEWWWWWW
