8
EEWWWEEE
WWWGWEEE
WEBEWWWE
WEEBEEWE
WGWEWEWE
WPWEEEWE
WWWWWWWE
EEEEEEEE
