8
EEEEEEEE
EEWWWWWE
EEWEEEWE
EEWEWEWE
EEWBEEWE
EEWWWEWE
EEEEWGWE
EEEEWWWE
