8
EEEEEEEE
EEEEEEEE
WWWWWWEE
WEEEEWEE
WEEBEWEE
WPEWWWWE
WEEEEGWE
WWWWWWWE
