8
EEEWWWWW
EEWWEBGW
EEWEEWWW
EEWEWWWW
EEWEEEEW
EEWWWWWW
EEEEEEEE
EEEEEEEE
