8
EEEEEEEE
EEEEEEEE
EEEEEEEE
EEWWWWEE
EEWEEWEE
EEWEBWWE
EEWEPGWE
EEWWWWWE
