8
EEWWWWWE
WWWEEEWE
WEBEWEWW
WEWEEGEW
WEEEEWEW
WWEWEEEW
EW2EEWWW
EWWWWWEE