8
WWWWWWWW
WWWWWWWW
WWWWWGWW
WWWWEEEW
WWWWEBWW
WWWWEEWW
WWWWWWWW
WWWWWWWW
