8
EEEEWWWE
EEEEWGWE
EEEEWEWE
EEEWWBWE
EEEWEEWE
EWWWEWWE
EWEEEWEE
EWWWWWEE
