10
EEEEWWWWEE
WWWWWEEWEE
WEEEBEEWEE
WEEGWEEWEE
WWEWWEWWEE
WEE2EEEWEE
WEEWEEEWEE
WEEWWWWWEE
WWWWEEEEEE
EEEEEEEEEE