8
EEEWWWWE
EEEWEEWE
EEEWBEWE
EEEWEEWE
WWWWEWWE
WEEEGWEE
WWWWWWEE
EEEEEEEE
