8
EEEEEEEE
EWWWWWEE
EWEEEWEE
EWEWEWEE
EWEBEWEE
EWGWWWEE
EWWWEEEE
EEEEEEEE
