8
EEEEEEEE
EEEEEEEE
EEWWWWWW
EWWEEEGW
EWGBEBWW
EWWWWEEW
EEEEWWWW
EEEEEEEE
