8
EEEWWWEE
WWWWGWEE
WEEBEWEE
WEWEEWEE
WEEEEWWE
WWWWEEWE
EEEWWPWE
EEEEWWWE
