8
WWWWWWWW
WEEWEEEW
WBEEPBEW
WGWWWWWW
WGWEEEEE
WWWEEEEE
EEEEEEEE
EEEEEEEE
