8
EEEEEEEE
EEEWWWEE
EEEWGWWW
EEWWBWGW
EEWEEBEW
EEWWWEEW
EEEEWWWW
EEEEEEEE
