8
EEEEWWWW
EWWWWEEW
WWEEEEBW
WEEWWWGW
WPWWEWWW
WWWEEEEE
EEEEEEEE
EEEEEEEE
