8
EEEEEEEE
EWWWWWEE
EWEEEWEE
EWEWEWEE
EWEWBWEE
EWEWGWEE
EWEWWWEE
EWWWEEEE
