10
EEEEWWWWEE
WWWWWEEWEE
WEEECEEWEE
WECGWEEWEE
WWEWWEWWEE
WEBEEEEWEE
WE2WEEEWEE
WEEWWWWWEE
WWWWEEEEEE
EEEEEEEEEE