8
EEEEEEEE
EEEWWWWW
EEEWGBEW
EEEWWWEW
EEEEWPEW
EEEEWBBW
EEEEWGGW
EEEEWWWW
