14
WWWWWWWWWWWWEE
WGGEEWEEEEEWWW
WGGEEWEBEEBEEW
WGGEEWBWWWWEEW
WGGEEEE2EWWEEW
WGGEEWEWEEBEWW
WWWWWWEWWBEBEW
EEWEBEEBEBEBEW
EEWEEEEWEEEEEW
EEWWWWWWWWWWWW
EEEEEEEEEEEEEE
EEEEEEEEEEEEEE
EEEEEEEEEEEEEE
EEEEEEEEEEEEEE