8
WWWWWWWW
WEBPEEGW
WEWEBEWW
WEEGWWWE
WWWWWEEE
EEEEEEEE
EEEEEEEE
EEEEEEEE
