8
EEEEWWWW
EEEWWEPW
WWWWEEWW
WEEEEWWE
WBWWWWEE
WGWEEEEE
WWWEEEEE
EEEEEEEE
