8
EEEEEEEE
EEEEEEEE
EWWWWWWE
EWGEBEWW
EWWEBEEW
EEWEWWWW
EEWGWEEE
EEWWWEEE
