8
EEWWWWWW
EWWEGEEW
EWPEWBEW
EWWWWEEW
EEEEWWWW
EEEEEEEE
EEEEEEEE
EEEEEEEE
