8
EEEWWWWW
EEEWEEEW
EEEWEBPW
EEEWWWEW
EEEEEWGW
EEEEEWWW
EEEEEEEE
EEEEEEEE
