8
EEEEEEEE
EEEEEEEE
EWWWWEEE
EWEEWEEE
WWPBWEEE
WEEGWEEE
WEBGWEEE
WWWWWEEE
