8
WWWWWWEE
WEEEGWEE
WEWEBWEE
WBWWEWEE
WGWWPWEE
WWWWWWEE
EEEEEEEE
EEEEEEEE
