12
EEEEEWWWWWWW
EEEEEWEEWEEW
WWWWWWEEEEEW
WEEEEWEEWEEW
WEEEEEEEWGWW
WWBWWWWWWGWW
WEEEBEE2EEEW
WEEEWWWWEEEW
WWWWWEEWWWWW
EEEEEEEEEEEE
EEEEEEEEEEEE
EEEEEEEEEEEE