8
EEEWWWWW
EEEWEBGW
EEEWEEWW
EEEWGBEW
EEEWPBEW
EEEWWWGW
EEEEEWWW
EEEEEEEE
