8
EEEEEEEE
WWWEEEEE
WPWWWWWW
WEEEGBEW
WWWEWEEW
EEWEEEWW
EEWWWWWE
EEEEEEEE
