8
EEEEWWWE
EEEEWGWE
EEEEWEWE
EWWWWBWE
EWEEPEWE
EWEBEEWE
EWWWWGWE
EEEEWWWE
