10
EEEEWWWWEE
EWWWWEEWWE
EWEBEEEEWE
EWEBEWGEWE
WWEWWWGWWE
WEEEEEEEWE
WEEEWEE2WE
WWWWWWWWWW
EEEEEEEEEE
EEEEEEEEEE