8
EEWWWWWW
EEWEBEGW
EEWEWWWW
EEWEWWWW
EEWEEEEW
EEWWWWWW
EEEEEEEE
EEEEEEEE
