8
WWWWWWEE
WEEEEWEE
WEBGEWWE
WWWWEPWE
EEEWWWWE
EEEEEEEE
EEEEEEEE
EEEEEEEE
