8
EEEWWWWW
EEEWGBEW
EWWWEEEW
EWEEEWWW
EWWWWWEE
EEEEEEEE
EEEEEEEE
EEEEEEEE
